+--------------------+
|[][][][][][][][]    |
|[][][][][][][][]    |
|[][][][][][][][]    |
|[][][][][][][][]    |
|                    |
|                    |
|                    |
|                    |
|                    |
|                    |
|                    |
|                    |
|                    |
|                    |
|                    |
+--------------------+
